{
    "map_properties": {
      "width": 15,
      "height": 13,
      "tile_width": 2,
      "tile_height": 2
    },
    "map_matrix": [
      [1, 1, 1, 1, 1, 1, 1, 1, 1, 1, 1, 1, 1, 1, 1],
      [1, 9, 9, 9, 0, 0, 0, 0, 0, 0, 0, 9, 9, 9, 1],
      [1, 9, 1, 0, 1, 0, 1, 0, 1, 0, 1, 0, 1, 9, 1],
      [1, 9, 0, 0, 0, 0, 0, 0, 0, 0, 0, 0, 0, 9, 1],
      [1, 0, 1, 0, 1, 0, 1, 0, 1, 0, 1, 0, 1, 0, 1],
      [1, 0, 0, 0, 0, 0, 0, 0, 0, 0, 0, 0, 0, 0, 1],
      [1, 0, 1, 0, 1, 0, 1, 0, 1, 0, 1, 0, 1, 0, 1],
      [1, 0, 0, 0, 0, 0, 0, 0, 0, 0, 0, 0, 0, 0, 1],
      [1, 0, 1, 0, 1, 0, 1, 0, 1, 0, 1, 0, 1, 0, 1],
      [1, 9, 0, 0, 0, 0, 0, 0, 0, 0, 0, 0, 0, 9, 1],
      [1, 9, 1, 0, 1, 0, 1, 0, 1, 0, 1, 0, 1, 9, 1],
      [1, 9, 9, 9, 0, 0, 0, 0, 0, 0, 0, 9, 9, 9, 1],
      [1, 1, 1, 1, 1, 1, 1, 1, 1, 1, 1, 1, 1, 1, 1]
    ]
    
  }
  